21 21 2
BREAK
0 0 0 0 0 0 0 0 0 0 0 0 0 0 0 0 0 0 0 0 0
0 0 0 0 0 0 0 0 0 0 0 0 0 0 0 0 0 0 0 0 0
0 0 0 0 0 0 0 0 0 0 0 0 0 0 0 0 0 0 0 0 0
0 0 0 0 0 0 0 0 0 0 0 0 0 0 0 0 0 0 0 0 0
0 0 0 0 3 3 3 3 3 0 0 0 3 3 3 3 3 0 0 0 0
0 0 0 0 3 3 3 3 3 0 0 0 3 3 3 3 3 0 0 0 0
0 0 0 0 3 3 3 3 3 0 0 0 3 3 3 3 3 0 0 0 0
0 0 0 0 3 3 3 3 3 0 0 0 3 3 3 3 3 0 0 0 0
0 0 0 0 3 3 3 3 3 0 0 0 3 3 3 3 3 0 0 0 0
0 0 0 0 0 0 0 0 0 0 0 0 0 0 0 0 0 0 0 0 0
0 0 0 0 0 0 0 0 0 0 0 0 0 0 0 0 0 0 0 0 0
0 0 0 0 0 0 0 0 0 0 0 0 0 0 0 0 0 0 0 0 0
0 0 0 0 3 3 3 3 3 0 0 0 3 3 3 3 3 0 0 0 0
0 0 0 0 3 3 3 3 3 0 0 0 3 3 3 3 3 0 0 0 0
0 0 0 0 3 3 3 3 3 0 0 0 3 3 3 3 3 0 0 0 0
0 0 0 0 3 3 3 3 3 0 0 0 3 3 3 3 3 0 0 0 0
0 0 0 0 3 3 3 3 3 0 0 0 3 3 3 3 3 0 0 0 0
0 0 0 0 0 0 0 0 0 0 0 0 0 0 0 0 0 0 0 0 0
0 0 0 0 0 0 0 0 0 0 0 0 0 0 0 0 0 0 0 0 0
0 0 0 0 0 0 0 0 0 0 0 0 0 0 0 0 0 0 0 0 0
0 0 0 0 0 0 0 0 0 0 0 0 0 0 0 0 0 0 0 0 0
BREAK
5 5 5 5 5 5 5 5 5 5 5 5 5 5 5 5 5 5 5 5 5
5 -1 -1 -1 -1 -1 -1 -1 -1 -1 -1 -1 -1 -1 -1 -1 -1 -1 -1 -1 5
5 -1 -1 -1 -1 -1 -1 -1 -1 -1 -1 -1 -1 -1 -1 -1 -1 -1 -1 -1 5
5 -1 -1 5 5 5 5 5 5 5 -1 5 5 5 5 5 5 5 -1 -1 5
5 -1 -1 5 -1 -1 -1 -1 -1 5 -1 5 -1 -1 -1 -1 -1 5 -1 -1 5
5 -1 -1 5 -1 -1 -1 -1 -1 5 -1 5 -1 -1 -1 -1 -1 5 -1 -1 5
5 -1 -1 5 -1 -1 -1 -1 -1 5 -1 5 -1 -1 -1 -1 -1 5 -1 -1 5
5 -1 -1 5 -1 -1 -1 -1 -1 5 -1 5 -1 -1 -1 -1 -1 5 -1 -1 5
5 -1 -1 5 -1 -1 -1 -1 -1 5 -1 5 -1 -1 -1 -1 -1 5 -1 -1 5
5 -1 -1 5 5 5 5 5 5 5 -1 5 5 5 5 5 5 5 -1 -1 5
5 -1 -1 -1 -1 -1 -1 -1 -1 -1 -1 -1 -1 -1 -1 -1 -1 -1 -1 -1 5
5 -1 -1 5 5 5 5 5 5 5 -1 5 5 5 5 5 5 5 -1 -1 5
5 -1 -1 5 -1 -1 -1 -1 -1 5 -1 5 -1 -1 -1 -1 -1 5 -1 -1 5
5 -1 -1 5 -1 -1 -1 -1 -1 5 -1 5 -1 -1 -1 -1 -1 5 -1 -1 5
5 -1 -1 5 -1 -1 -1 -1 -1 5 -1 5 -1 -1 -1 -1 -1 5 -1 -1 5
5 -1 -1 5 -1 -1 -1 -1 -1 5 -1 5 -1 -1 -1 -1 -1 5 -1 -1 5
5 -1 -1 5 -1 -1 -1 -1 -1 5 -1 5 -1 -1 -1 -1 -1 5 -1 -1 5
5 -1 -1 5 5 5 5 5 5 5 -1 5 5 5 5 5 5 5 -1 -1 5
5 -1 -1 -1 -1 -1 -1 -1 -1 -1 -1 -1 -1 -1 -1 -1 -1 -1 -1 -1 5
5 -1 -1 -1 -1 -1 -1 -1 -1 -1 -1 -1 -1 -1 -1 -1 -1 -1 -1 -1 5
5 5 5 5 5 5 5 5 5 5 5 5 5 5 5 5 5 5 5 5 5
BREAK
1 1 1 1 1 1 1 1 1 1 1 1 1 1 1 1 1 1 1 1 1
1 0 0 0 0 0 0 0 0 0 0 0 0 0 0 0 0 0 0 0 1
1 0 0 0 0 0 0 0 0 0 0 0 0 0 0 0 0 0 0 0 1
1 0 0 1 1 1 1 1 1 1 0 1 1 1 1 1 1 1 0 0 1
1 0 0 1 0 0 0 0 0 1 0 1 0 0 0 0 0 1 0 0 1
1 0 0 1 0 0 0 0 0 1 0 1 0 0 0 0 0 1 0 0 1
1 0 0 1 0 0 0 0 0 0 0 0 0 0 0 0 0 1 0 0 1
1 0 0 1 0 0 0 0 0 1 0 1 0 0 0 0 0 1 0 0 1
1 0 0 1 0 0 0 0 0 1 0 1 0 0 0 0 0 1 0 0 1
1 0 0 1 1 1 0 1 1 1 0 1 1 1 0 1 1 1 0 0 1
1 0 0 0 0 0 0 0 0 0 0 0 0 0 0 0 0 0 0 0 1
1 0 0 1 1 1 0 1 1 1 0 1 1 1 0 1 1 1 0 0 1
1 0 0 1 0 0 0 0 0 1 0 1 0 0 0 0 0 1 0 0 1
1 0 0 1 0 0 0 0 0 1 0 1 0 0 0 0 0 1 0 0 1
1 0 0 1 0 0 0 0 0 0 0 0 0 0 0 0 0 1 0 0 1
1 0 0 1 0 0 0 0 0 1 0 1 0 0 0 0 0 1 0 0 1
1 0 0 1 0 0 0 0 0 1 0 1 0 0 0 0 0 1 0 0 1
1 0 0 1 1 1 1 1 1 1 0 1 1 1 1 1 1 1 0 0 1
1 0 0 0 0 0 0 0 0 0 0 0 0 0 0 0 0 0 0 0 1
1 0 0 0 0 0 0 0 0 0 0 0 0 0 0 0 0 0 0 0 1
1 1 1 1 1 1 1 1 1 1 1 1 1 1 1 1 1 1 1 1 1
BREAK
