10 8 1
BREAK
10 10 10 10 10 10 10 10 10 10
10 17 17 17 17 17 17 17 17 10
10 17 17 17 17 17 17 17 17 10
10 17 17 17 17 17 17 17 17 10
10 17 17 17 17 17 17 17 17 10
10 17 17 17 17 17 17 17 17 10
10 17 17 17 17 17 17 17 17 10
10 10 10 10 17 17 10 10 10 10
BREAK
1 1 1 1 1 1 1 1 1 1
1 0 0 0 0 0 0 0 0 1
1 0 0 0 0 0 0 0 0 1
1 0 0 0 0 0 0 0 0 1
1 0 0 0 0 0 0 0 0 1
1 0 0 0 0 0 0 0 0 1
1 0 0 0 0 0 0 0 0 1
1 1 1 1 0 0 1 1 1 1
BREAK
